000000000000000
002000000000200
020000000000020
020000000000020
022000222000220
002202222202200
020222222222020
000022222220000
000222222222000
002202222202200
022000000000220
220200000002022
202000000000202
000000000000000
000000000000000
Pyro-GX from the game Descent