220224444422202
200004444400002
008004444400002
200004444400002
200004444400002
444441111144444
444441111144444
4444411q1144444
444441111144444
444441111144444
200004444400002
200004444400002
200004444400002
000004444400002
222224444422222
Test level