000000000000000
000222000000000
002222220000000
002022222000000
002222202200000
020222000220000
020000000022000
022220000002200
022222222000220
020002222222220
022220000222220
022222222000020
022222222222220
000002222222220
000000000222220
A piece of cake